{
  "schema": 1,
  "version": "1.0.0",
  "name": "Duel",
  "tiles": [
    "....................",
    "....................",
    "....##........##....",
    "....##........##....",
    "........oo..........",
    "....................",
    "......#.....#.......",
    "....................",
    "......#.....#.......",
    "....................",
    "..........oo........",
    "....##........##....",
    "....##........##....",
    "....................",
    "...................."
  ]
}
